2 2 2 4 5 6 2 2 2 2 2 2 2 2 3 9
2 2 2 3 9 7 2 2 2 2 2 2 2 2 3 9
6 2 2 3 9 7 2 4 5 6 2 2 2 2 3 9
7 2 2 3 9 7 2 3 9 7 4 5 6 2 3 9
7 2 2 3 9 7 2 3 9 7 3 9 7 2 3 9
7 2 2 3 8 7 2 3 8 7 3 8 7 2 3 8
1 1 1 1 1 1 1 1 1 1 1 1 1 1 1 1 
0 0 0 0 0 0 0 0 0 0 0 0 0 0 0 0
0 0 0 0 0 0 0 0 0 0 0 0 0 0 0 0